..............................................................................
..............................................................................
...........................G..............................................X...
..........................###.....................................############
......................G.......................................................
.....................###................G.GDG.............G.G.G...............
.................G....................#########..........#######..............
................###...........................................................
............G...................G.G...............G.G.........................
...........###.................#####.............#####........................
..............................................................................
..............................................................................
........................................................##.G.G.G.G.G.G.G.G.G..
.1............................................................................
##############################################################################